################################
#  ###         ########        #
####### #####     ####  ####   #
### s # #########        ####  #
###     ##    #####        ##  #
### ### ## ##            ####  #
#   ### ##    #  ##   ##       #
#   #      ####     ##### ######
##      ##  ###   # ###       ##
####   ###       #  ### ### # ##
######     ####   #      e  ####
################################