#############
#   #       #
#  #### #   #
#   s # #  e#
#       ##  #
#  ######   #
#   ###  #  #
#           #
#############